5 5 5 5 5 5 5 5 5 5 5 5 5 5 5 5 5 5 5 5 5 5 5 5 5 5 5 5 5 5 5 5 5 5 5 5 5 5 5 5 5 5 5 5 5 5 5 5 5 5
5 5 5 5 5 5 5 5 5 5 5 5 5 5 5 5 5 5 5 5 5 5 5 5 5 5 5 5 5 5 5 5 5 5 5 5 5 5 5 5 5 5 5 5 5 5 5 5 5 5
5 5 5 5 5 5 5 5 5 5 5 5 5 5 5 5 5 5 5 5 5 5 5 5 5 5 5 5 5 5 5 5 5 5 5 5 5 5 5 5 5 5 5 5 5 5 5 5 5 5
5 5 5 5 5 5 5 5 5 5 5 5 5 5 5 5 5 5 5 5 5 5 5 5 5 5 5 5 5 5 5 5 5 5 5 5 5 5 5 5 5 5 5 5 5 5 5 5 5 5
5 5 5 5 5 5 5 5 5 5 5 5 5 5 5 5 5 5 5 5 5 5 5 5 5 5 5 5 5 5 5 5 5 5 5 5 5 5 5 5 5 5 5 5 5 5 5 5 5 5
5 5 5 5 5 5 5 5 5 5 5 5 5 5 5 5 5 5 5 5 5 5 5 5 5 5 5 5 5 5 5 5 5 5 5 5 5 5 5 5 5 5 5 5 5 5 5 5 5 5
5 5 5 5 5 5 25 8 8 8 8 8 8 8 8 8 8 8 8 8 8 8 8 8 8 8 8 8 8 8 8 8 8 8 8 8 8 8 8 8 8 8 8 8 8 8 29 5 5 5
5 5 5 5 5 5 9 0 1 15 20 4 2 4 0 0 4 4 1 0 0 0 0 1 0 0 0 0 0 0 2 0 0 0 0 4 0 0 0 0 0 0 2 0 0 10 6 5 5 5
5 5 5 5 5 5 9 0 0 0 16 0 4 0 4 4 0 4 1 1 0 0 0 0 0 0 0 0 0 0 1 0 0 0 0 0 4 4 0 4 0 0 2 0 0 10 6 5 5 5
5 5 5 5 5 5 9 0 0 0 17 15 20 22 4 0 0 0 0 1 0 0 2 0 1 0 0 0 0 0 0 0 0 0 0 4 1 4 4 0 0 0 2 0 0 10 6 5 5 5
5 5 5 5 5 5 9 0 0 0 0 0 16 0 2 4 0 1 1 0 0 0 0 0 1 0 0 0 0 2 0 0 0 0 0 1 0 1 4 4 0 0 0 2 0 10 6 5 5 5
5 5 5 5 5 5 9 0 0 0 0 4 16 23 0 0 0 0 0 0 0 0 0 0 0 0 0 0 0 0 0 0 0 0 0 0 0 4 4 4 4 0 4 0 0 10 6 5 5 5
5 5 5 5 5 5 9 0 0 0 4 4 16 21 0 0 28 33 33 33 33 33 33 33 33 29 0 1 0 0 0 4 4 4 4 0 2 0 0 0 0 0 2 0 0 10 6 5 5 5
5 5 5 5 5 5 9 0 0 0 0 22 16 0 0 0 32 0 0 0 0 0 0 0 0 32 0 0 0 0 0 0 0 4 4 0 4 4 0 0 0 0 2 0 0 10 6 5 5 5
5 5 5 5 5 5 9 0 0 0 0 0 17 20 21 0 32 0 34 38 37 0 0 0 0 32 0 0 0 0 4 4 4 0 1 0 1 4 0 0 0 0 2 0 0 10 6 5 5 5
5 5 5 5 5 5 9 0 2 0 0 0 0 16 0 0 32 0 35 0 35 0 0 0 0 32 0 0 0 0 0 0 0 4 4 4 1 4 4 4 0 0 2 0 0 10 6 5 5 5
5 5 5 5 5 5 9 0 0 0 0 0 23 16 0 0 32 0 0 0 0 0 0 0 0 32 0 0 0 0 0 0 0 0 0 1 4 4 4 0 0 2 0 0 10 6 5 5 5 5
5 5 5 5 5 5 9 0 0 0 0 0 21 16 0 0 30 33 33 33 16 33 33 33 33 31 0 0 0 0 0 0 4 4 4 1 0 0 0 0 0 2 0 0 10 6 5 5 5 5
5 5 5 5 5 5 9 0 0 0 0 0 0 17 15 40 15 15 15 15 18 0 0 0 0 0 0 0 4 4 0 0 0 0 0 0 1 0 0 0 0 0 2 0 0 10 6 5 5 5
5 5 5 5 5 5 9 0 1 2 0 0 0 0 23 16 0 4 4 4 4 4 4 1 4 0 0 0 0 0 0 0 0 0 0 0 1 0 0 0 0 0 2 0 0 10 6 5 5 5
5 5 5 5 5 5 9 0 0 0 0 0 21 0 0 16 0 0 4 4 4 4 4 4 0 0 0 0 0 0 0 0 0 0 1 0 1 0 0 0 0 0 2 0 0 10 6 5 5 5
5 5 5 5 5 5 9 0 0 0 0 0 22 21 23 16 0 4 4 4 4 2 1 1 0 0 0 0 0 0 0 0 0 0 1 1 1 0 0 0 0 0 2 0 0 10 6 5 5 5
5 5 5 5 5 5 9 0 0 0 0 0 0 0 0 17 15 15 15 15 15 15 15 15 15 15 20 0 0 0 0 0 0 0 1 1 1 0 0 0 0 0 2 0 0 10 6 5 5 5
5 5 5 5 5 5 9 0 0 0 0 0 0 0 0 0 0 0 0 1 0 0 0 0 0 0 16 0 0 0 0 0 0 0 1 1 1 0 0 0 0 0 2 0 0 10 6 5 5 5
5 5 5 5 5 5 9 0 0 2 0 0 0 0 0 0 0 0 1 0 2 0 0 4 0 0 16 0 0 0 0 0 0 0 1 0 1 0 0 0 0 0 2 0 0 10 6 5 5 5
5 5 5 5 5 5 9 0 0 0 0 0 0 0 0 0 0 0 0 0 0 0 0 0 0 0 16 0 0 0 0 4 0 0 0 0 0 0 0 0 0 0 0 0 0 10 6 5 5 5
5 5 5 5 5 5 9 0 0 0 0 2 0 0 0 0 0 0 0 0 0 0 0 0 0 0 16 0 0 1 0 0 0 0 4 0 0 0 0 0 0 0 0 0 0 10 6 5 5 5
5 5 5 5 5 5 9 0 0 0 4 0 0 0 0 0 0 4 0 0 0 0 0 0 0 0 16 0 0 0 0 4 0 0 0 0 0 0 0 0 0 0 0 0 0 10 6 5 5 5
5 5 5 5 5 5 9 0 4 1 0 4 0 4 0 0 0 0 0 0 0 0 4 0 0 0 16 0 0 0 0 0 0 0 0 0 2 0 0 0 0 0 0 0 0 10 6 5 5 5
5 5 5 5 5 5 9 0 4 4 4 0 4 4 4 0 0 0 0 0 0 0 2 2 0 0 16 0 0 0 0 0 0 0 0 0 0 0 0 0 2 0 0 0 0 10 6 5 5 5
5 5 5 5 5 5 9 0 0 0 4 4 4 4 4 0 0 4 0 0 0 0 0 1 0 0 17 15 15 15 15 20 0 0 0 0 0 0 0 0 0 0 4 0 0 10 6 5 5 5
5 5 5 5 5 5 9 0 0 0 0 4 0 0 4 0 4 0 0 0 0 0 0 0 0 0 0 0 0 0 0 16 0 0 0 0 0 0 0 0 0 0 0 0 4 4 0 10 6 5 5 5
5 5 5 5 5 5 9 0 0 0 0 0 0 4 0 4 4 4 0 0 0 0 0 0 0 0 0 0 0 0 0 16 0 0 0 0 0 0 0 0 1 0 0 4 4 0 0 10 6 5 5 5
5 5 5 5 5 5 9 0 0 0 2 0 0 4 4 4 4 4 4 4 0 0 0 0 0 1 0 0 0 0 0 16 0 0 0 2 0 0 0 0 0 0 4 4 0 0 10 6 5 5 5
5 5 5 5 5 5 9 0 0 0 0 1 0 0 4 4 4 4 4 4 4 4 4 0 0 0 0 0 0 0 0 16 0 0 0 0 0 0 0 0 0 0 4 4 0 0 0 10 6 5 5 5
5 5 5 5 5 5 9 0 0 0 0 0 0 0 0 0 0 0 4 4 4 4 4 4 4 0 0 0 0 0 0 16 0 0 0 0 0 0 0 0 0 0 1 4 0 0 0 10 6 5 5 5
